9 9
0 1 0 0 0 0 0 1 0
0 1 0 2 0 2 0 1 0
0 2 0 1 0 1 0 2 0
0 0 0 1 0 1 0 0 0
1 1 0 3 0 3 0 1 1
0 0 0 1 0 1 0 0 0
0 2 0 1 0 1 0 2 0
0 1 0 2 0 2 0 1 0
0 1 0 0 0 0 0 1 0
0.5 0.5 0
8.5 0.5 0
0.5 8.5 180
8.5 8.5 180
4.5 4.5
